40 40
0000000000100000000000000100010111011000
0000000001000000000001000100011010011000
0000000010000000000001000010100000101000
0000000110000000000000000011010011010000
0000000100000000000100000010101110010000
0000000100000101001100000110001110010000
0000001000001001101000001001110100010000
0000001000100010110000001011101100100000
0000010100000010110000011011110100100000
0000011000000011110000111110111001000000
0000010000000010101011011100101001000000
0000110000000001001100111001001000000000
0001010000000011001100111010001001000000
0010010000000001010101100010001010000000
0010010000000011100101100110011001100000
0100010000010011001011101110011111000000
0100001000100011010111001000011110000000
0100000001000101000111010000011100000000
0000000000000001101111100000111100000000
1000000010001001101001000010110001101100
1000000100001010111111100101101110011100
1100001111110000110111110010101000101100
0110110000110100111110110100111000001100
0000010010011000110010011100110001001000
0000101000111001111010011001110010001000
0001001000110011010100000001101100001000
0010010000010011011100000001010000011000
0010000000110111111100000001100000010000
0001000000101101100100000011100000010000
0110000000111010100100000111100000010000
1100000001011101000000001111100000010000
1000000011110110000000010111110000110000
1000000011101110000000100101000000010000
0000000110111100000011000110001000100000
0000000111011100000110000010001000100000
0000001100101000001000000110100000100000
0000011101000000110000000101100001100000
0000110001000010000000001100000001000000
0000100011001100000000000100000001000000
0001000011100000000000010000000001000000
